20  21  21  21  21  21  21  21  21  21  21  21  21  22  30  30  30  30  30  30  30  30  30  30  30  30  30  30  30  30  30  30  30  30  30  30  30  30  30  30  30  30  30  30  20  21  21  21  21  21  21  21  21  21  21  21  21  21  21  22
23  24  24  24  24  24  24  24  24  24  24  24  24  25  0  0  0  0  0  0  0  0  0  0  0  0  0  0  0  0  0  0 0  0  0  0  0  0  0  0  0  0  0  0  23  0  0  0  0  0  0  0  0  0  0  0  0  0  0  25
23  24  24  24  24  24  24  24  27  27  27  27  27  28  0  10  11  11  11  11  11  11  11  11  11  11  11  11  11  11  11   11  11  11  11  11  11  11  11  11  11  11  11  12  23  0  0  0  0  0  0  0  0  0  0  0  0  0  0  25
23  24  24  24  24  24  24  25  30  30  30  30  30  31  0  13  14  14  14  14  14  14  14  14  14  14  14  14  14  14  14   14  14  14  14  14  14  14  14  14  14  14  14  15  23  0  0  0  0  0  0  0  0  0  0  0  0  0  0  25
23  24  24  24  24  24  24  25  0   0   0   0   0   0   0  13  14  6  17  17  17  17  17  17  17  17  17  17  17  17   17   17  17  17  17  17  17  17  17  17  17  8  14  15  23  0  0  0  0  0  0  0  0  0  0  0  0  0  0  25
26  27  27  27  27  27  27  28  0  0  10  11  11  11  11  9  14  15  0  0  0  0  0  0  0  0  0  0  0  0  0  0 0  0  0  0  0  0  0  0  0  13  14  15  23  0  0  0  0  0  0  0  0  0  0  0  0  0  0  25
30  30  30  30  30  30  30  31  0  0  13  14  14  14  14  14  14  15  0  0  0  0  0  0  0  0  0  0  0  0  0  0 0  0  0  0  0  0  0  0  0  13  14  15  23  0  0  0  0  0  0  0  0  0  0  0  0  0  0  25
25  0   0   0   0   0   0   0   0  0  13  14  6  17  17  17  17  18  0  0  0  0  0  0  0  0  0  0  0  0  0  0 0  0  0  0  0  0  0  0  0  13  14  15  23  0  0  0  0  0  0  0  0  0  0  0  0  0  0  25
25  0  0  0  0  0  0  0  0  0  13  14  15  0  0  0  0  0  0  0  0  20  21  21  21  21  21  21  21  21  21   21  21  21  21  21  21  21  21  21  22  13  14  15  23  0  0  0  0  0  0  0  0  0  0  0  0  0  0  25
25  0  0  0  0  0  0  0  0  0  13  14  15  0  0  0  0  0  0  0  0  23  0  0  0  0  0  0  0  0  0  0 0  0  0  0  0  0  0  0  25  16  17  18  23  0  0  0  0  0  0  0  0  0  0  0  0  0  0  25
25  0  0  0  0  0  0  0  0  0  13  14  15  0  0  0  0  0  0  0  0  26  27  27  27  27  27  27  27  27  27   27  27  27  27  27  27  27  24  0  24  21  21  21  24  0  0  0  0  0  0  0  0  0  0  0  0  0  0  25
25  0  0  10  11  11  12  0  0  0  13  14  15  0  0  0  0  0  0  0  0  29  30  30  30  30  30  30  30  30   30   30  30  30  30  30  30  30  23  27  27  27  27  27  27  27  27  27  27  27  27  27  27  27  27  27  27  27  27  28
25  0  0  13  14  14  7  11  11  11  9   14  7   11  11  11  11  11  11  11  11  11  11  11  11  11  11  11  11  11  11   11  11 11  12  0  0  0  29  30  30  30  30  30  30  30  30  30  30  30  30  30  30  30  30  30  30  30  30  31
25  0  0  13  14  14  14  14  14  14  14  14  14  14  14  14  14  14  14  14  14  14  14  14  14  14  14  14  14  14  14   14  14  14  15  0  0  0  0  0  0  0  0  0  0  0  0  0  10  11  11  11  11  11  11  11  11  11  11  11
25  0  0  13  14  14  6  17  17  17  17  17  17  17  17  17  17  17  17  17  17  17  17  17  8  14  6  17  17  17  17   17  17  17  18  0  0  0  0  0  0  0  0  0  0  0  0  0  13  14  14  14  14  14  14  14  14  14  14  14
25  0  0  16  17  17  18  0  0  0  0  0  0  0  0  0  0  0  0  0  0  0  0  0  13  14  15  0   0   0  0  0  0   0   0   0   0   0   0   0   0   0   0   0   0   0   0   0   13   14   6   17   17   17  17  17  17  17  17  17
25  0  0   0   0   0   0  0  0  0  0  0  0  0  0  0  0  0  0  0  0  0  0  0  13  14  15  0   0   0  0  0  0   0   0   0   0   0   0   0   0   0   0   0   0   0   0   0   13   14   15   20   21   21  21  21  21  21  21  21
25  20  21  21  21  21  21  21  21  21  21  21  21  21  21  21  21  21  21  21  21  21  22  0  13  14  15  0   0   0  0  0  0   0   0   0   0   0   0   0   0   0   0   0   0   0   0   0   13   14   15   23   0  0  0  0  0  0  0  0
25  23  0   0   0   0   0   0   0   0   0   0   0   0   0   0   0   0   0   0   0   0   25  0  13  14  7  11  11  11  11  11 11  11  11  11  11  11  11  11  11  11  11  11  11  11  11  11   9  14  15  23  0  0  0  0  0  0  0  0
25  23  0   0   0   0   0   0  0   0   0   0   0   0   0   0   0   0   0   0   0   0   25  0  13  14  14  14  14  14  14  14  14  14  14  14  14  14  14  14  14  14  14  14  14  14  14  14  14  14  15  23  0  0  0  0  0  0  0  0
25  27  27  27  27  27  27  27  27  27  27  27  27  27  27  27  27  27  27  27  27  27  28  0  13  14  6  17  17  17  17  17  17  17  17  17  17  17  17  17  17  17  17  17  17  17  17  17  17  17  18  23  0  0  0  0  0  0  0  0
25  30  30  30  30  30  30  30  30  30  30  30  30  30  30  30  30  30  30  30  30  30  31  0  13  14  15  0  0  0  20  21  21   21  21  21  21  21  21  21  21  21  21  21  21  21  21  21  21  21  21  0  0  0  0  0  0  0  0  0
25  0  0   0   0   0   0   0   0   0   0   0   0   0   0   0   0   0   0   0   0   0   0   0   13  14  15  0  0  0  26  27  27  27  27  27  27  27  27  27  27  27  27  27  27  0  0  0  0  0  0  0  0  0  0  0  0  0  0  0
25  0  0   0   0   0   0   0   0   0   0   0   0   0   0   0   0   0   0   0   0   0   0   0   13  14  15  0  0  0  29  30  30   30  30  30  30  30  30  30  30  30  30  30  30  23  0  0  0  0  0  0  0  0  0  0  0  0  0  0
25  0  0  0  10  11  11  11  11  11  11  11  11  11  11  11  11  11  11  11  11  11  11  11  9  14  7  11  11  11  11  11  11  11  11  11  11  11  11  11  11  11  11  11  12  23  0  0  0  0  0  0  0  0  0  0  0  0  0  0
25  0  0  0  13  14  14  14  14  14  14  14  14  14  14  14  14  14  14  14  14  14  14  14  14  14  14  14  14  14  14   14  14  14  14  14  14  14  14  14  14  14  14  14  15  23  0  0  0  0  0  0  0  0  0  0  0  0  0  0
25  0  0  0  13  14  6  17  17  17  17  17  17  17  17  17  17  17  17  17  17  17  17  17  17  17  17  17  17  17  17  17  17  17  17  17  17  17  17  17  17  17  8  14  15  23  27  27  27  27  27  27  27  27  27  27  27  27  27  27
25  0  0  0  13  14  15  20  21  21  21  21  21  21  21  21  21  21  21  21  21  21  21  22  0  0  0  0  0  0  0  0 0  0  0  0  0  0  0  0  0  0  13  14  15  29  30  30  30  30  30  30  30  30  30  30  30  30  30  30
25  0  0  0  13  14  15  23  0  0  0  0  0  0  0  0  0  0  0  0  0  0  0  25  0  0  0  0  0  0  0  0 0  0  0  0  0  0  0  0  0  0  13  14  15  0  0  0  0  0  0  0  0  0  0  0  0  0  0  23
25  0  0  0  16  17  18  23  0  0  0  0  0  0  0  0  0  0  0  0  0  0  0  25  0  0  10  11  11  11  11   11  11  11  11  11  11  11  11  11  11  11  9  14  15  0  0  0  0  0  0  0  0  0  0  0  0  0  0  23
25  21  21  21  21  21  21  0  0  0  0  0  0  0  0  0  0  0  0  0  0  0  0  25  0  0  13  14  14  14  14   14  14  14  14  14  14  14  14  14  14  14  14  14  15  0  0  0  0  0  0  0  0  0  0  0  0  0  0  23
23  27  27  27  27  27  27  27  27  27  27  27  27  27  27  27  27  27  27  27  27  27  27  25  0  0  16  17  17  17  17 17  17 17  17  17  17  17  17  17  17  17  17  17  18  0  0  0  0  0  0  0  0  0  0  0  0  0  0  23
29  30  30  30  30  30  30  30  30  30  30  30  30  30  30  30  30  30  30  30  30  30  30  31  21  21  21  21  21  21  21  21 21  21  21  21  21  21  21  21  21  21  21  21  21  21  21  21  21  21  21  21  21  21  21  21  21  21  21  29