25 30 30 30 30 30 30 30 30 30 30 30 30 30 30 30 30 30 30 30 30 30 30 30 30 30 30 30 30 30 30 30 30 30 30 30 30 30 30 30 30 30 30 30 31 13 14 15 29 30 30 30 30 30 30 30 30 30 30 23
25  0  0  0  0  0  0  0  0  0  0  0  0  0  0  0  0  0  0  0  0  0  0  0  0  0  0  0  0  0  0  0  0  0  0  0 13 14 15 23  0  0  0  0  0 13 14 15  0  0  0  0  0  0  0  0  0  0  0 23
25  0  0  0  0  0  0 10 11 11 11 11 11 11 11 11 11 11 11 11 11 11 11 11 11 11 12  0  0  0  0  0  0  0  0  0 13 14 15 23  0  0  0  0  0 13 14 15  0  0  0  0  0  0  0  0  0  0  0 23
25  0  0  0  0  0  0 13 14 14 14 14 14 14 14 14 14 14 14 14 14 14 14 14 14 14 15  0  0  0  0  0  0  0  0  0 13 14 15 23  0  0  0  0  0 13 14 15  0  0  0  0  0  0  0  0  0  0  0 23
25  0  0  0  0  0  0 13 14 6  17 17 17 17 17 17 17 17 17 17 17 17 17 17 8  14 15  0  0  0  0  0  0  0  0  0 13 14 15 23  0  0  0  0  0 13 14 15  0  0  0  0  0  0  0  0  0  0  0 23
25  0  0  0  0  0  0 13 14 15  0  0  0  0  0  0  0  0  0  0  0  0  0  0 13 14 15  0  0  0  0  0  0  0  0  0 13 14 15 23  0  0  0  0  0 13 14 15  0  0  0  0  0  0  0  0  0  0  0 23
25  0  0  0  0  0  0 13 14 15  0  0  0  0  0  0  0  0  0  0  0  0  0  0 13 14 15  0  0  0  0  0  0  0  0  0 13 14 15 23  0  0  0  0  0 13 14  7 11 11 11 11 11 11 11 12  0  0  0 23
25  0  0  0  0  0  0 13 14 15  0  0  0  0  0  0  0  0  0  0  0  0  0  0 13 14 7  11 11 11 11 11 11 11 11 11  9 14 15 23  0  0  0  0  0 13 14 14 14 14 14 14 14 14 14 15  0  0  0 23
25  0  0  0  0  0  0 13 14 15  0  0  0  0  0  0  0  0  0  0  0  0  0  0 13 14 14 14 14 14 14 14 14 14 14 14 14 14 15 23  0  0  0  0  0 16 17 17 17 17 17 17 17  8 14 15  0  0  0 23
25  0  0  0  0  0  0 13 14 15  0  0  0  0  0  0  0  0  0  0  0  0  0  0 16 17 17 17 17 17 17 17 17 17 17 17 17 17 18 23  0  0  0  0  0  0  0  0  0  0  0  0  0 13 14 15  0  0  0 23
11 11 11 11 11 11 11  9 14 15  0  0  0  0  0  0  0  0  0  0  0  0  0  0  0  0  0  0  0  0  0  0  0  0  0  0  0  0  0 23  0  0  0  0  0  0  0  0  0  0  0  0  0 13 14 15  0  0  0 23
14 14 14 14 14 14 14 14 14 15  0  0  0  0  0  0  0  0  0  0  0  0  0  0  0  0  0  0  0  0  0  0  0  0  0  0  0  0  0 23  0  0  0  0  0  0  0  0  0  0  0  0  0 13 14 15  0  0  0 23
17 17 17 17 17 17 17  8 14 15 20 21 21 21 21 21 21 21 21 21 21 21 21 21 21 21 21 21 21 21 21 21 21 21 21 21 21 21 21  0  0  0  0  0  0  0  0  0  0  0  0  0  0 13 14 15  0  0  0 23
25  0  0  0  0  0  0 13 14 15 23  0  0  0  0  0  0  0  0  0  0  0  0  0  0  0  0  0  0  0  0  0  0  0  0  0  0  0  0  0  0  0  0  0  0  0  0  0  0  0  0  0  0 13 14 15  0  0  0 23
25  0  0  0  0  0  0 13 14 15 23  0  0  0  0  0  0  0  0  0  0  0  0  0  0  0  0  0  0  0  0  0  0  0  0  0  0  0  0  0  0  0  0  0  0  0  0  0  0  0  0  0  0 13 14 15  0  0  0 23
25  0  0  0  0  0  0 13 14 15 23  0  0  0  0  0  0  0  0  0  0  0  0  0  0  0  0  0  0  0  0  0  0  0  0  0  0  0  0  0  0  0  0  0  0  0  0  0  0  0  0  0  0 13 14 15  0  0  0 23
25  0  0  0  0  0  0 13 14 15 23  0  0  0 10 11 11 11 11 11 11 11 11 11 11 11 11 11 11 11 11 11 11 11 11 11 11 11 11 11 11 12  0  0  0  0  0  0  0  0  0  0  0 13 14 15  0  0  0 23
25  0  0  0  0  0  0 13 14 15 23  0  0  0 13 14 14 14 14 14 14 14 14 14 14 14 14 14 14 14 14 14 14 14 14 14 14 14 14 14 14 15  0  0  0  0  0  0  0  0  0  0  0 13 14 15  0  0  0 23
25  0  0  0  0  0  0 13 14 15 23  0  0  0 13 14  6 17 17 17 17 17 17 17 17 17 17 17 17 17  8 14  6 17 17 17 17 17 17  8 14 15  0  0  0  0  0  0  0  0  0  0  0 13 14 15  0  0  0 23
25  0 10 11 11 11 11  9 14 15 23  0  0  0 13 14 15  0  0  0  0  0  0  0  0  0  0  0  0  0 13 14 15  0  0  0  0  0  0 13 14 15  0  0  0  0  0  0  0  0  0  0  0 13 14 15  0  0  0 23
25  0 13 14 14 14 14 14 14 15 23  0  0  0 13 14 15  0  0  0  0  0  0  0  0  0  0  0  0  0 13 14 15  0  0  0  0  0  0 13 14  7 11 11 11 11 11 11 11 11 11 11 11  9 14  7 11 11 11 23
25  0 13 14  6 17 17 17 17 18 23  0  0  0 13 14 15  0  0  0  0  0  0  0  0  0  0  0  0  0 13 14 15  0  0  0  0  0  0 13 14 14 14 14 14 14 14 14 14 14 14 14 14 14 14 14 14 14 14 23
25  0 13 14 15  0  0 20 21 21  0  0  0  0 13 14 15  0  0  0  0  0  0  0  0  0  0  0  0  0 13 14 15  0  0  0  0  0  0 16 17 17 17 17 17 17 17 17 17 17 17 17 17 17 17 17 17 17 17 23
25  0 13 14 15  0  0 23  0  0  0  0  0  0 16 17 18  0  0  0  0  0  0  0  0  0  0  0  0  0 13 14 15  0  0  0  0  0  0  0  0  0  0  0  0  0  0  0  0  0  0  0  0  0  0  0  0  0  0 23
25  0 13 14 15  0  0 26 27 27 27 27 27 27 27 27 27 27 27 27 27 27 27 27 27 27 27 27 27 27 13 14 15 27 27 27 27 27 27 27 27 27 27 27 27 27 27 27 27 27 27 27 27 27 27 27 27 27 27 23
25  0 13 14 15  0  0 29 30 30 30 30 30 30 30 30 30 30 30 30 30 30 30 30 30 30 30 30 30 30 34 35 36 30 30 30 30 30 30 30 30 30 30 30 30 30 30 30 30 30 30 30 30 30 30 30 30 30 30 23
25  0 13 14 15  0  0  0  0  0  0  0  0  0  0  0  0  0  0  0  0  0  0  0  0  0  0  0  0  0 37 38 39  0  0  0  0  0  0  0  0  0  0  0  0  0  0  0  0  0  0  0  0  0  0  0  0  0  0 23
25  0 13 14  7 11 11 11 11 11 11 11 11 11 11 11 11 11 11 11 11 11 11 11 11 11 11 11 11 11  9 14  7 11 11 11 11 11 11 11 11 11 11 11 11 11 11 11 11 11 11 11 11 11 11 11 11 12  0 23
25  0 13 14 14 14 14 14 14 14 14 14 14 14 14 14 14 14 14 14 14 14 14 14 14 14 14 14 14 14 14 14 14 14 14 14 14 14 14 14 14 14 14 14 14 14 14 14 14 14 14 14 14 14 14 14 14 15  0 23
25  0 16 17 17 17 17 17 17 17 17 17 17 17 17 17 17 17 17 17 17 17 17 17 17 17 17 17 17 17 17 17 17 17 17 17 17 17 17 17 17 17 17 17 17 17 17 17 17 17 17 17 17 17 17  8 14 15  0 23
25  0  0  0  0  0  0  0  0  0  0  0  0  0  0  0  0  0  0  0  0  0  0  0  0  0  0  0  0  0  0  0  0  0  0  0  0  0  0  0  0  0  0  0  0  0  0  0  0  0  0  0  0  0  0 13 14 15  0 23
25  0  0  0  0  0  0  0  0  0  0  0  0  0  0  0  0  0  0  0  0  0  0  0  0  0  0  0  0  0  0  0  0  0  0  0  0  0  0  0  0  0  0  0  0  0  0  0  0  0  0  0  0  0  0 16 17 18  0 23
25 21 21 21 21 21 21 21 21 21 21 21 21 21 21 21 21 21 21 21 21 21 21 21 21 21 21 21 21 21 21 21 21 21 21 21 21 21 21 21 21 21 21 21 21 21 21 21 21 21 21 21 21 21 21 21 21 21 21 23