50 43 43 43 43 43 43 43 43 43 43 43 43 43 43 43 43 43 43 43 43 43 43 43 43 43 43 43 43 43 43 43 43 43 43 43 43 43 43 43 43 43 43 43 43 43 43 43 43 43 43 43 43 43 43 43 43 43 43 51
48 40 40 40 40 40 40 40 47 40 40 40 47 40 40 40 40 40 40 40 40 40 40 40 40 40 40 40 40 40 40 40 40 40 40 40 40 40 40 40 40 40 40 47 40 40 40 40 40 40 40 40 40 40 40 40 40 40 40 47
48 40 40 40 40 40 40 40 47 40 40 40 47 40 40 40 40 40 40 40 40 40 40 40 40 40 40 40 40 40 40 40 40 40 40 40 40 40 40 40 40 40 40 47 40 40 40 40 40 40 40 40 40 40 40 40 40 40 40 47
48 40 40 40 40 40 40 40 47 40 40 40 47 40 40 40 40 40 40 40 40 40 40 40 40 40 40 40 40 40 40 40 40 40 40 40 40 40 40 40 40 40 40 40 40 40 40 40 40 40 40 40 40 40 40 40 40 40 40 47
48 40 40 40 40 40 40 40 47 40 40 40 47 40 40 40 40 40 40 40 40 40 40 40 40 40 40 40 40 40 40 40 40 40 40 40 40 40 40 40 40 40 40 40 40 40 40 40 40 40 40 40 40 40 40 40 40 40 40 47
48 40 40 40 40 40 40 40 47 40 40 40 47 40 40 40 40 40 40 40 40 40 40 40 40 40 40 40 40 40 40 40 40 40 40 40 40 40 40 40 40 40 40 40 40 40 40 40 40 40 40 40 40 40 40 40 40 40 40 47
48 40 40 40 40 40 40 40 40 40 40 40 47 40 40 40 40 40 40 40 40 40 40 40 40 40 40 40 40 40 40 40 40 40 40 40 40 40 40 40 40 40 40 47 40 40 40 40 40 40 40 40 40 40 40 40 40 40 40 47
48 40 40 40 40 40 40 40 40 40 40 40 47 40 40 40 40 40 40 40 40 40 40 40 40 40 40 40 40 40 40 40 40 40 40 40 40 40 40 40 40 40 40 47 40 40 40 40 40 40 40 40 40 40 40 40 40 40 40 47
48 40 40 40 40 40 40 40 40 40 40 40 47 41 42 43 44 45 46 41 42 43 44 45 46 41 42 43 44 45 46 41 42 43 44 45 46 41 42 43 44 44 45 46 41 42 43 44 45 46 40 40 40 41 42 43 44 45 46 47
48 40 40 40 40 40 40 40 47 40 40 40 47 40 40 40 40 40 40 40 40 40 40 40 40 40 40 40 47 40 40 40 40 40 40 40 40 40 40 40 40 40 40 40 40 40 40 40 40 40 40 40 40 40 40 40 40 40 40 47
48 40 40 40 40 40 40 40 47 40 40 40 47 40 40 40 40 40 40 40 40 40 40 40 40 40 40 40 47 40 40 40 40 40 40 40 40 40 40 40 40 40 40 40 40 40 40 40 40 40 40 40 40 40 40 40 40 40 40 47
48 49 49 40 40 40 49 49 47 40 40 40 47 40 40 40 40 40 40 40 40 40 40 40 40 40 40 40 40 40 40 40 40 40 40 40 40 40 40 40 40 40 40 40 40 40 40 40 40 40 40 40 40 40 40 40 40 40 40 47
48 40 40 40 40 40 40 40 47 40 40 40 47 40 40 40 40 40 40 40 40 40 40 40 40 40 40 40 40 40 40 40 40 40 40 40 40 40 40 40 40 40 40 40 40 40 40 40 40 40 40 40 40 40 40 40 40 40 40 47
48 40 40 40 40 40 40 40 47 40 40 40 47 40 40 40 40 40 40 40 40 40 40 40 40 40 40 40 40 40 40 40 40 40 40 40 40 40 40 40 40 40 40 40 40 40 40 40 40 40 40 40 40 40 40 40 40 40 40 47
48 40 40 40 40 40 40 40 47 40 40 40 47 40 40 40 40 40 40 40 40 40 40 40 40 40 40 40 47 40 40 40 40 40 40 40 40 40 40 40 40 40 40 40 40 40 40 40 40 40 40 40 40 40 40 40 40 40 40 47
48 40 40 40 40 40 40 40 40 40 40 40 40 40 40 40 40 40 40 40 40 40 40 40 40 40 40 40 49 49 49 49 49 49 49 49 49 49 49 49 49 49 49 51 40 40 40 40 40 40 40 40 40 40 40 40 40 40 40 47
48 40 40 40 40 40 40 40 40 40 40 40 40 40 40 40 40 40 40 40 40 40 40 40 40 40 40 40 47 40 40 40 40 40 40 40 40 40 40 40 40 40 40 48 40 40 40 40 40 40 40 40 40 40 40 40 40 40 40 47
48 40 40 40 40 40 40 40 40 40 40 40 40 40 40 40 40 40 40 40 40 40 40 40 40 40 40 40 47 40 40 40 40 40 40 40 40 40 40 40 40 40 40 48 40 40 40 40 40 40 40 40 40 40 40 40 40 40 40 47
48 40 40 40 40 40 40 40 47 40 40 40 47 40 40 40 40 40 40 40 40 40 40 40 40 40 40 40 47 40 40 40 40 40 40 40 40 40 40 40 40 40 40 48 40 40 40 40 40 40 40 40 40 40 40 40 40 40 40 47
48 40 40 40 40 40 40 40 47 40 40 40 47 40 40 40 40 40 40 40 40 40 40 40 40 40 40 40 47 40 40 40 40 40 40 40 40 40 40 40 40 40 40 48 40 40 40 40 40 40 40 40 40 40 40 40 40 40 40 47
48 40 40 40 40 40 40 40 47 40 40 40 47 40 40 40 40 40 40 40 40 40 40 40 40 40 40 40 47 40 40 40 40 40 40 40 40 40 40 40 40 40 40 48 40 40 40 40 40 40 40 40 40 40 40 40 40 40 40 47
48 40 40 40 40 40 40 40 47 40 40 40 47 40 40 40 40 40 40 40 40 40 40 40 40 40 40 40 47 40 40 40 40 40 40 40 40 40 40 40 40 40 40 48 40 40 40 40 40 40 40 40 40 40 40 40 40 40 40 47
48 40 40 40 40 40 40 40 47 40 40 40 47 40 40 40 40 40 40 40 40 40 40 40 40 40 40 40 47 40 40 40 40 40 40 40 40 40 40 40 40 40 40 48 40 40 40 40 40 40 40 40 40 40 40 40 40 40 40 47
48 49 49 49 49 49 49 49 53 40 40 40 52 49 49 49 49 49 49 49 49 49 49 49 49 49 49 49 47 40 40 40 41 42 43 44 45 46 41 42 43 43 43 43 43 45 46 41 42 43 44 45 46 41 42 43 44 45 46 47
48 40 40 40 40 40 40 40 40 40 40 40 40 40 40 40 40 40 40 40 40 40 40 40 40 40 40 40 40 40 40 40 40 40 40 40 40 40 40 40 40 40 40 40 40 40 40 40 40 40 40 40 40 40 40 40 40 40 40 47
48 40 40 40 40 40 40 40 40 40 40 40 40 40 40 40 40 40 40 40 40 40 40 40 40 40 40 40 40 40 40 40 40 40 40 40 40 40 40 40 40 40 40 40 40 40 40 40 40 40 40 40 40 40 40 40 40 40 40 47
48 40 40 40 40 40 40 40 40 40 40 40 40 40 40 40 40 40 40 40 40 40 40 40 40 40 40 40 40 40 40 40 40 40 40 40 40 40 40 40 40 40 40 40 40 40 40 40 40 40 40 40 40 40 40 40 40 40 40 47
48 40 40 40 50 49 49 49 49 49 49 49 49 49 49 49 49 49 49 49 49 49 49 49 49 49 49 49 49 40 40 40 49 49 49 49 49 49 49 49 49 49 49 49 51 40 40 40 50 49 49 40 40 40 49 51 40 40 40 47
48 40 40 40 40 40 40 40 40 40 40 40 40 40 40 40 40 40 40 40 40 40 40 40 40 47 40 40 40 40 40 40 40 40 40 40 40 40 40 40 40 40 40 40 48 40 40 40 47 40 40 40 40 40 40 48 40 40 40 47
48 40 40 40 40 40 40 40 40 40 40 40 40 40 40 40 40 40 40 40 40 40 40 40 40 47 40 40 40 40 40 40 40 40 40 40 40 40 40 40 40 40 40 40 48 40 40 40 47 40 40 40 40 40 40 48 40 40 40 47
48 40 40 40 40 40 40 40 40 40 40 40 40 40 40 40 40 40 40 40 40 40 40 40 40 47 40 40 40 40 40 40 40 40 40 40 40 40 40 40 40 40 40 40 48 40 40 40 47 40 40 40 40 40 40 48 40 40 40 47
48 40 40 40 47 40 40 40 40 40 40 40 40 40 40 40 40 40 40 40 40 40 40 40 40 47 40 40 40 40 40 40 40 40 40 40 40 40 40 40 40 40 40 40 48 40 40 40 47 40 40 40 40 40 40 48 40 40 40 47
52 49 49 49 49 49 49 49 49 49 49 49 49 49 49 49 49 49 49 49 49 49 49 49 49 49 49 49 49 49 49 49 49 49 49 49 49 49 49 49 49 49 49 49 49 40 40 40 49 49 49 49 49 49 49 49 49 49 49 53